02,02,02,02,02,02,02,02,02,02,02,02,02,02,02,02,02,02,02,02
02,03,00,00,00,00,00,00,00,00,00,00,00,00,00,00,00,00,03,02
02,03,00,00,00,00,00,00,00,00,00,00,00,00,00,00,00,00,03,02
02,03,01,01,00,00,00,01,01,01,01,01,01,00,00,00,01,01,03,02
02,03,00,00,00,00,00,00,00,00,00,00,00,00,00,00,00,00,03,02
02,03,00,00,00,00,00,00,00,00,00,00,00,00,00,00,00,00,03,02
02,03,01,01,00,00,00,02,02,02,02,02,02,00,00,00,01,01,03,02
02,03,00,00,00,00,00,00,00,00,00,00,00,00,00,00,00,00,03,02
02,03,00,00,00,00,00,00,00,00,00,00,00,00,00,00,00,00,03,02
02,03,00,00,00,00,00,00,00,00,00,00,00,00,00,00,00,00,03,02
02,03,01,01,00,00,00,01,01,01,01,01,01,00,00,00,01,01,03,02
02,03,00,00,00,00,00,00,00,00,00,00,00,00,00,00,00,00,03,02
02,03,00,00,00,00,00,00,00,00,00,00,00,00,00,00,00,00,03,02
02,03,00,00,00,00,00,00,00,00,00,00,00,00,00,00,00,00,03,02
02,02,02,02,02,02,02,02,02,02,02,02,02,02,02,02,02,02,02,02